NO ./path_to_the_north_texture
SO ./path_to_the_south_texture
WE ./path_to_the_west_texture
EA ./path_to_the_east_texture
F 220,100,0
C 225,30,0

11111111111111111111111
10000000000000000000001
10000000000000000000001
10000000000000000000001
10000022220000303030001
10000020020000000000001
10000020020000300030001
10000020020000000000001
10000020220000303030001
10000000000000000000001
10000000000000000000001
10000000000000000000001
10000000000000000000001
10000000000000000000001
10000000000000000000001
10000000000000000000001
14444444000000000000001
14040004000000000000001
14000054000000000000001
14040004000000000000001
14044444000000000000001
14000000000000000000001
14444444000000000000001
11111111111111111111111